111111111111111111111111111111
1P0000C000100000C0000000000001
101011101010101110001010111011
10000000001000C010001000000001
101010101110111010101110101011
1C0000000010000100010000000001
101110101010111011101010111011
100010001000000000010000C00001
101010101011101010101110101011
100000000000100000000000000001
101010111010101011101010111011
1C000000010001C0000001000000C1
101110101011111011101011100011
100000C000000000C0000000000001
1010001010101110111010101C10E1
111111111111111111111111111111
