111111111111111111111111111111111111111111111111111111111111
1E0000000000000C00000C000000000000000000000C00000C0000000001
101001010010000010100100000001010101001000001010010000000101
101001001010101000100100000001010100101010100010010000000101
1P0000000C00C0000000000000000000C0000C00C0000000000000000001
101001010010000010100100000001010101001000001010010000000101
101001010010000010100100000001010101001000001010010000000101
101001010010000010100100000001010101001000001010010000000101
101001010010000010100100000001010101001000001010010000000101
101001010010000010100100000001010101001000001010010000000101
101001010010000010100100000001010101001000001010010000000101
101001010010000010100100000001010101001000001010010000000101
101001010010000010100100000001010101001000001010010000000101
101001010010000010100100000001010101001000001010010000000101
101001010010000010100100000001010101001000001010010000000101
101001010010000010100100000001010101001000001010010000000101
101001010010000010100100000001010101001000001010010000000101
101001010010000010100100000001010101001000001010010000000101
101001001010101000100100000001010100101010100010010000000101
101001001010101000100100000001010100101010100010010000000101
101001001010101000100100000001010100101010100010010000000101
101001001010101000100100000001010100101010100010010000000101
101001001010101000100100000001010100101010100010010000000101
101001001010101000100100000001010100101010100010010000000101
101001001010101000100100000001010100101010100010010000000101
101001001010101000100100000001010100101010100010010000000101
101001001010101000100100000001010100101010100010010000000101
101001001010101000100100000001010100101010100010010000000101
101001001010101000100100000001010100101010100010010000000101
101001001010101000100100000001010100101010100010010000000101
101001001010101000100100000001010100101010100010010000000101
111111111111111111111111111111111111111111111111111111111111
