1111111111111111111111111111111111111111111111111111111111111
1E0000000000000C00000C000000000000000000000000000000000000011
1010010100100000101001000000010101010010000010100100000001011
1010010010101010001001000000010101001010101000100100000001011
1P0000000C00C000000000000000000000000000000000000000000000011
1010010100100000101001000000010101010010000010100100000001011
1010010100100000101001000000010101010010000010100100000001011
1010010100100000101001000000010101010010000010100100000001011
1010010100100000101001000000010101010010000010100100000001011
1010010100100000101001000000010101010010000010100100000001011
1010010100100000101001000000010101010010000010100100000001011
1010010100100000101001000000010101010010000010100100000001011
1010010100100000101001000000010101010010000010100100000001011
1010010100100000101001000000010101010010000010100100000001011
1010010100100000101001000000010101010010000010100100000001011
1010010100100000101001000000010101010010000010100100000001011
1010010100100000101001000000010101010010000010100100000001011
1010010100100000101001000000010101010010000010100100000001011
1010010010101010001001000000010101001010101000100100000001011
1010010010101010001001000000010101001010101000100100000001011
1010010010101010001001000000010101001010101000100100000001011
1010010010101010001001000000010101001010101000100100000001011
1010010010101010001001000000010101001010101000100100000001011
1010010010101010001001000000010101001010101000100100000001011
1010010010101010001001000000010101001010101000100100000001011
1010010010101010001001000000010101001010101000100100000001011
1010010010101010001001000000010101001010101000100100000001011
1010010010101010001001000000010101001010101000100100000001011
1010010010101010001001000000010101001010101000100100000001011
1010010010101010001001000000010101001010101000100100000001011
1010010010101010001001000000010101001010101000100100000001011
1111111111111111111111111111111111111111111111111111111111111
1111111111111111111111111111111111111111111111111111111111111
