1111111111
1P000C10C1
1010110011
1C001001C1
1011101001
1000100001
1010101101
100000C1E1
1111111111
