1111111111111
1C010000000C1
1010011111001
1P0011E000101
1111111111111
